19,22
###################
#........#........#
#*##.###.#.###.##*#
#.##.###.#.###.##.#
#.................#
#.##.#.#####.#.##.#
#....#...#...#....#
####.### # ###.####
   #.#       #.#   
W###.# ##G## #.###W
    .  # P #  .    
W###.# ##### #.###W
   #.#   R   #.#   
####.# ##### #.####
#........#........#
#.##.###.#.###.##.#
#*.#.....S.....#.*#
##.#.#.#####.#.#.##
#....#...#...#....#
#.######.#.######.#
#.................#
###################